42424242424262626272424262700
00000000030301000103000301030
00000000004272524000425272706
00000000000000000000000000030
40000000700000500000000000005
03000001030001030000000000000
42624260004240004000000000000
00030103000000000300000000000
00504040424000004040000000000
01030103010300010303000000000
40004000700072400040600040004
00000000000003000003030103010
00000000000000526242424242524
