42425272424262600042424000000
00000301030103030100000300000
00500072407000424000400042427
01030100030001030301030001010
40004000004250007270005242400
00000000000103000003000100000
00000042424000500000524000005
00000100010300030000000000010
40007000400042724000524000400
03010001000001030301000301030
00500060000040004242724240005
00000100000100000003010300010
42724242724000000000400042400
