40004242427242500000000000000
03010000000103030000000000000
40400040004242427260000000005
03000103010000000303000000010
40427000400000004252424242525
03000001000000010003010301030
00424260006000400000400050004
01000103010301000000000000000
40004000400050000000000000000
00010000030103000000000000000
42600000004000524252500000000
00000000010300000103030000000
42424272500072726000425242427
