40000000524252425000000000000
03000001000000000300000000000
42427240004000000070000000000
01030003010300000003000000000
40007000600042700000424000424
00000300000000030000010301030
40004042700042425000424242704
03010300030101000301000000030
00500050004040400042500070004
00000003000101030103030103000
40000000425242425000405000624
03000000010000000300030001030
42426252400000000072724240004
