00424242426242624242425262424
01010003010103000103030103000
40400000524000427272524242400
01030001000000010100030103030
42424270004000524000004000724
03000103010301000000000300000
00426000627250000000000062600
00000000000000000000000000030
00000000000000000000000000004
00000000000000000000000000000
00000000400000000000000000004
00000001030000000000000000010
42426240007242424242424242500
