42400000400000427242725270004
03030001030001000300010303010
00624240004250000052400062425
00000003010000000001030001000
00000000400000004250424240627
00000000000000010301000301010
00700000700062700040004262400
01030001030101000000010000000
40006242624270400042625260007
00010101000301030100000003010
42725240000040007000000000400
01010000000003010000000000000
42500000000000400000000000000
