00000000524270007250000042627
00000001000003010003000100010
40004270004000524240624000600
03010103010301030003000001000
42425000400040007000426242400
03010301030100000301030100030
42424040007000424242524000005
00000300000001000000000000000
42500042426250000000004270004
00030000000000000000010003010
40004242400062727242400000407
03000000030101030000000000010
00725272524250007252426242500
