00000000000042600042426242425
00000000000100030100000300000
00004272424000005000000040004
00010000000000010000000003010
42400000004000600000000000400
00000000010301000000000000000
40007252424242400000000000000
03010001000000030000000000000
40400040000040005242425240004
03000100000103010000000303010
00424260005000400000000072424
00010303010300000000000000010
42425272700042427252525242500
