42424242624000400042400000424
01030001030301030103030001000
40004240004242424000624240004
03000103000003000000000103010
00425240524242400040004070400
00010003000003030103010103030
00400000400042427260404242524
01000000030100030303010000000
40000000004000005042400000000
00000000000000000300000000000
00000000000000000042500052424
00000000000000000000030100000
00000000000000000000005000000
