00004240000000000000424000424
00010003000000000001000301000
42500040500052400070000040000
00000103030101030100000000000
40004000424260004270000000000
03010000000000000003000000000
00400000000000000000400042500
00000000000000000000030101030
00000000000000426272524270004
00000000000001000000000000000
00007262500040000040005000424
00010103030103000103010301030
42724242524242427242424262724
