40000000500042424242424240004
03000001030103010001030303010
00524240004000400060005272724
01030100010300000100000000000
40004000600040007000000000000
00010301030003010000000000000
42624240004000424260000000000
00000100000301000003000000000
00004000000070000000600000000
00010000000000000000030000000
42400000400000600000004242425
00030001030001030000010300000
00004240004240004272600072424
