42527262424252500000004240004
00030103010303030000010303010
42525000400072604242427252500
00000300000100030001000003030
00000042724000005240000042424
00000000000000000300000100000
00000000000000000040007000000
00000000000000000003010000000
00000000000000000000400000004
00000000000000000000000000010
42724250000060004000400000400
01030003000103010301030001000
40004252524242725242424242424
