00004272424000624272424270000
00010000010301010300000003000
00400000700052424040000000500
01000001000001000303000001030
40007240004250000040424262427
03010003010000000003010103000
42424000400000424242424000400
00000300000001000000000000030
00000040004270500040004000006
00000003010301030103010300000
40000052400040004052425040000
03000100000103000100000303000
42427252424000424000000072424
