00000000424000425242424240004
00000001030301010003000003010
42700070004252400000724000400
03030100000000000000000301030
00726000400000004000424270004
00030001030000010301000000000
00426250004000700070000000000
01000003000301000000000000000
40004240426272724000400040007
03010003010301030301030103010
00400000504060004242424000404
00030000010300010301030300010
00004262700042400060004242426
