00000000000000000000000000000
00000000000000000000000000000
42500000000000000000524240000
00030000000000000001000003000
00007000000000006272425000424
00000300000000010100000300000
00000062424000404000426042427
00000000000301010001010300010
42400042724262600052524242407
03030103010301030101000003010
00526242424060004252700000424
00010000030300010100030001000
42425242524242524000004250000
