40004000424252724252427242725
03010301030100030100030103010
42424242527000426000424242424
01000301000301000301010000000
40000040000050004242700000000
00000000000003010000000000000
00000000000000504000000000000
00000000000000010300000000000
00625000400072400040000000427
01000301030100000103000001000
42400050004000424000400040424
00030103000001000000030101000
00004000424240000000004250000
