00000000005000000000000042424
00000000010300000000000100000
42424000700040000000004000424
00000301000003000000010001010
42700040007242727252400050400
00030103010103010101030101030
00004070504000505040704242424
00000103010000010101030103010
00007000504272627070004000400
00010000010001000100000000000
42400052400040006000000000000
01030100000100010000000000000
42724242524262400000000000000
