00000000000000000042424252424
00000000000000000100000000000
00005000500000425000000000000
00010301030001000000000000000
00424240004260000000004242724
01010003010300000000010000000
40404000424040005242500040000
01010301030303010303000103000
42400040004242400042424000400
00000000000001030000030000030
40000000500042406000004000004
03000001030100030300000300000
42625250005000007272526252524
