00000000000000000062724242424
00000000000000000100000103000
00425000700000005000424000524
01010301030000010301000000000
40500042424262400040000042424
01000000010301030103000101030
40000000400040004000424070004
03000001000000010300000100000
00424260007000400042724000000
01030000010301000001030000000
42605000500040005242424242600
00030301030103010100000300030
42424252526242524000000042726
