00400000000000000000000000000
01030000000000000000000000000
40007240000000000000000000006
00000003000000000000000000010
00400000524242400000000000400
01030000000000030000000001000
40005250005272404000000050000
00000003010000030300000100000
42624000404000004040004000000
00030300010300000303010300000
00625262400040000042600042426
01000003000103000001030001030
42424272725242424252725252624
