42400042424272624000000000000
01030101030000000300000000000
40007242424272527260000000004
00000100010301030003000000010
40004000400060004240724242525
03010301000003010303030101000
42500070000000400070624250000
00000000000000000003010300000
40000040000000000000404262400
03000103000000000000010000030
00424272424242400000400000004
01000000000301030001000000000
40000000000040007262724242424
