42424000424242424242400000000
03000301010300010003030000000
00426272400042400000404000000
01030100030103000000030300000
40005000005000524000007070004
00000000000000000300010303010
40000000006000400042400042425
03000000010301030000000001030
40724242400050007240004240004
03010301030103010303010000000
00404250004000407042400000000
00010003010300010300030000000
42400000600042400072425272424
