42524252400000004000600000600
00010300030000010301030001030
00400042405242626040604240004
01000000030001000301030103010
40000000004240000040007000500
00000000000103000000000000000
40000042424272524242400042524
03000101010301030000030100010
40424260500050007000004242400
03010301000000000300000001000
00400050000000725042724250000
01030103000001000300010300000
40007000724240000042400042624
