40004000427000600072527000004
03010301000301030101030300010
42627242426242524270007242727
00000100030103000000000101030
00004000404000424000004270007
00010001030000000300010000000
00707240004240000072700000000
01010000010303000001000000000
42400042400040427240005242424
01030101030003000000010000000
40004270004240600042500000004
00000000000003030100000000010
00000000000000424242427242400
