40000042425270000000424262525
03000100000003000001000001010
42624042400000424272627270400
00030100030000010103000001000
42424270004000424040427242400
00010303010301000103000100030
42400052427240004000424000424
00000003010003010000000001030
00400000700000527000004240004
01030000000000000300010100000
40004270000000000042704000000
00000003000000000000010000000
00000000425252524272700000000
