42600000000072524242424272400
01030000000100010301030300030
40004240005000400070004042707
00000303010001000000000300030
00000042424250700000400060005
00000001010301030001030003010
00424272400050005240004000400
01000100000000000000000301000
40004000000000424272424240000
00010000000001030000000003000
42700000400040004270000000425
01030001030100000003000001030
42524242527000000000625240004
