00000042424000624000000040005
00000100000301000300000103010
42425000000050004040004052424
03000000000000010303010101000
00425000000052400042425040000
00000300000101030103000100000
40004250004250004040724000000
03010003010000010103030000000
40400072400072404000425250007
03000100030100010000000303010
00425272406042400000000042400
00010103030100000000000103030
42424000425242724242425000424
